1112121212121111
1000000000000001
1000000000000001
7000000000000004
1000000000000005
1000000000000006
1000000000000004
1000000000000005
1313131313000006
1000000000000004
1000000000000005
9000000000000006
8000000000000001
8000000000000001
11111A1A1A111111